DD.d...DD
.DDDDD...
.....D.d.
0..F.D.D.
12dF..dD.
DDDDDDDD.
DDDDDDDG.
DDDDDDDD.
DDDDDDDDd
DDDDDDDDD
