G.......
........
...F.P..
......dd
...4..DD
...3E.dD
..12DDDD
..0DDDDD
